काठमाडौँ	काठमाडौँ $	काठमाडौँ 
छाती	छाती $	छा ती
दुखिरहने	दुखिरहने $	दुखिर हने
समस्या	समस्या $	स मस्या
भएपछि	भए पछि	भ एपछि
बाराका	बारा का	बा राका
वर्षिय	वर्षिय $	वर् षिय
एक	एक $	ए क
विरामी	विरामी $	वि रामी
बाँसबारीस्थित	बाँसबारी स्थित	बाँसबारी स्थित
शहीद	शहीद $	श हीद
गंगालाल	गंगालाल $	गंगा लाल
राष्ट्रिय	राष्ट्रिय $	राष् ट्रिय
हृदयरोग	हृदयरोग $	हृदयरो ग
केन्द्रमा	केन्द्र मा	केन्द् रमा
भर्ना	भर्ना $	भ र्ना
भए	भए $	भ ए
गत	गत $	ग त
जेठ	जेठ $	जे ठ
गते	गते $	ग ते
उनको	उन को	उन को
मुटुको	मुटु को	मुटु को
शल्यक्रिया	शल्यक्रिया $	श ल्यक्रिया
भयो	भयो $	भ यो
शल्यक्रियाको	शल्यक्रिया को	शल्यक्रि याको
दिनपछि	दिन पछि	दिन पछि
अस्पतालबाट	अस्पताल बाट	अस्पता लबाट
डिस्चार्ज	डिस्चार्ज $	डि स्चार्ज
पनि	पनि $	प नि
अपरेशनपछि	अपरेशन पछि	अप रेशनपछि
भाइको	भाइ को	भा इको
अवस्था	अवस्था $	अ वस्था
ठीकै	ठी कै	ठी कै
थियो	थियो $	थि यो
खाने	खाने $	खा ने
बोल्ने	बोल्ने $	बो ल्ने
सुत्ने	सुत्ने $	सु त्ने
सबै	सबै $	स बै
सामान्य	सामान्य $	सा मान्य
बिरामीका	बिरामी का	बिरामी का
आफन्तले	आफन्त ले	आफ न्तले
भने	भने $	भ ने
दिनमै	दिन मै	दिन मै
छातीको	छाती को	छाती को
बाहिरी	बाहिरी $	बा हिरी
भागबाट	भाग बाट	भा गबाट
पानी	पानी $	पा नी
निस्किने	निस्किने $	निस् किने
थिच्दा	थिच्दा $	थि च्दा
मुखबाट	मुख बाट	मुख बाट
पिप	पिप $	पि प
आउने	आउने $	आ उने
हुन	हुन $	हु न
थाल्यो	थाल्यो $	थाल् यो
शल्यक्रियापछि	शल्यक्रिया पछि	शल्यक्रिया पछि
हुने	हुने $	हु ने
संक्रमणका	संक्रमण का	संक्रम णका
कारण	कारण $	का रण
उनलाई	उन लाई	उनला ई
यस्तो	यस्तो $	यस् तो
भएको	भए को	भ एको
फलोअप	फलोअप $	फ लोअप
उपचारबाट	उपचार बाट	उपचार बाट
पत्ता	पत्ता $	पत् ता
लाग्यो	लाग्यो $	ला ग्यो
संक्रमणले	संक्रमण ले	संक्रम णले
उनको	उन को	उ नको
मात्रै	मात्रै $	मा त्रै
बिग्रिएन	बिग्रिएन $	बिग् रिएन
दोह्र्याएर	दोह्र्याएर $	दोह् र्याएर
गनुपर्ने	गनु पर्ने	ग नुपर्ने
हाल	हाल $	हा ल
अस्पतालले	अस्पताल ले	अस् पतालले
उनको	उन को	उन को
गरिदिएको	गरिदिए को	गरि दिएको
उनी	उनी $	उ नी
अहिले	अहिले $	अहि ले
अस्पतालको	अस्पताल को	अस् पतालको
बेडमा	बेड मा	बे डमा
मृत्युसँग	मृत्यु सँग	मृत्यु सँग
लडिरहेका	लडि रहेका	लडि रहेका
छन्	छन् $	छ न्
आफन्त	आफन्त $	आफ न्त
भन्छन्	भन्छन् $	भ न्छन्
मुटु	मुटु $	मु टु
खोलेको	खोले को	खो लेको
बिरामी	बिरामी $	बि रामी
बाँच्दैन	बाँच्दैन $	बाँच् दैन
डर	डर $	ड र
लागिरहेको	लागि रहेको	लागि रहेको
अस्पतालमा	अस्पताल मा	अस् पतालमा
मुटुको	मुटु को	मुटु को
शल्यक्रियापछि	शल्यक्रिया पछि	शल्यक्रिया पछि
संक्रमणका	संक्रमण का	संक्रम णका
ज्यान	ज्यान $	ज् यान
जोखिममा	जोखिम मा	जोखि ममा
परेका	परे का	प रेका
उदाहरण	उदाहरण $	उदा हरण
हुन्	हुन् $	हु न्
संक्रमणका	संक्रमण का	संक्रम णका
बिरामीले	बिरामी ले	बिरा मीले
पोस्टअप	पोस्टअप $	पो स्टअप
वार्ड	वार्ड $	वार् ड
गरिएका	गरिए का	गरिए का
राख्ने	राख्ने $	राख् ने
कक्ष	कक्ष $	क क्ष
भरिएको	भरिए को	भ रिएको
सफल	सफल $	स फल
भएपनि	भए पनि	भए पनि
कति	कति $	क ति
संक्रमणकै	संक्रमण कै	सं क्रमणकै
गुमाइरहेका	गुमाइ रहेका	गुमा इरहेका
गुणस्तरिय	गुणस्तरिय $	गुणस्त रिय
ढंगले	ढंग ले	ढं गले
नहुनुको	नहुनु को	नहु नुको
मुख्य	मुख्य $	मु ख्य
प्रोत्साहन	प्रोत्साहन $	प्रोत्सा हन
भत्ता	भत्ता $	भत् ता
अस्पतालमा	अस्पताल मा	अस् पतालमा
शल्यचिकित्सकले	शल्यचिकित्सक ले	शल्यचिकित्स कले
मासिक	मासिक $	मा सिक
तलब	तलब $	त लब
बाहेक	बाहेक $	बा हेक
कार्यालय	कार्यालय $	का र्यालय
समयमै	समय मै	सम यमै
काम	काम $	का म
गरेवापत	गरेवापत $	गरे वापत
थप	थप $	थ प
पाइरहेका	पाइ रहेका	पा इरहेका
प्रोत्साहनभत्ता	प्रोत्साहनभत्ता $	प्रोत्साहनभ त्ता
अस्पतालमा	अस्पताल मा	अस् पतालमा
वरिष्ठ	वरिष्ठ $	वरि ष्ठ
चिकित्सक	चिकित्सक $	चिकित्स क
टिकाइराख्न	टिकाइराख्न $	टिकाइरा ख्न
उनीहरूको	उनी हरूको	उ नीहरूको
निजि	निजि $	नि जि
अभ्यास	अभ्यास $	अभ्या स
रोक्नका	रोक्न का	रोक् नका
लागि	लागि $	ला गि
विस	विस $	वि स
देखि	देखि $	दे खि
प्रोत्साहनभत्ताको	प्रोत्साहनभत्ता को	प्रोत्साहनभत् ताको
व्यवस्था	व्यवस्था $	व्यवस् था
गरिएको	गरिए को	गरिए को
नेपालको	नेपाल को	नेपा लको
अन्य	अन्य $	अ न्य
कुनै	कुनै $	कु नै
अस्पतालमा	अस्पताल मा	अस् पतालमा
छैन	छैन $	छै न
लिएपनि	लिए पनि	लिए पनि
उनीहरूको	उनी हरूको	उ नीहरूको
नीजि	नीजि $	नी जि
रोकिएको	रोकिए को	रो किएको
सरकारले	सरकार ले	सरकार ले
बाथमुटुरोगको	बाथमुटुरोग को	बाथमुटुरो गको
निशुल्क	निशुल्क $	नि शुल्क
गरेसँगै	गरे सँगै	गरे सँगै
चिकित्सकले	चिकित्सक ले	चिकित्स कले
सरकारी	सरकारी $	सरका री
बजेटबाटै	बजेट बाटै	बजेट बाटै
खाँदै	खाँदै $	खाँ दै
आइरहेका	आइ रहेका	आइर हेका
अस्पताल	अस्पताल $	अस् पताल
सञ्चालक	सञ्चालक $	सञ्चाल क
समितीकै	समिती कै	स मितीकै
निणर्यमा	निणर्य मा	निणर् यमा
भएको	भए को	भए को
अनुसार	अनुसार $	अ नुसार
शल्यक्रियामा	शल्यक्रिया मा	श ल्यक्रियामा
संलग्न	संलग्न $	सं लग्न
रजिष्टार	रजिष्टार $	र जिष्टार
एनेस्थिेसियोलोजिस्ट	एनेस्थिेसियोलोजिस्ट $	ए नेस्थिेसियोलोजिस्ट
बेहोश	बेहोश $	बे होश
बनाउने	बनाउने $	बना उने
कार्यसम्पादन	कार्यसम्पादन $	कार्य सम्पादन
बरिष्ठताका	बरिष्ठता का	बरि ष्ठताका
आधारमा	आधार मा	आ धारमा
आइरहेका	आइ रहेका	आ इरहेका
जुन	जुन $	जु न
तलबभत्ता	तलबभत्ता $	तल बभत्ता
बाहेकको	बाहेक को	बाहे कको
हिसाब	हिसाब $	हि साब
गर्दा	गर्दा $	ग र्दा
प्रोत्साहनभत्ताको	प्रोत्साहनभत्ता को	प्रोत्साहनभत् ताको
रकम	रकम $	र कम
बढि	बढि $	ब ढि
देखिन्छ	देखिन्छ $	देखि न्छ
शल्यक्रियाका	शल्यक्रिया का	शल्यक्रि याका
जति	जति $	ज ति
धेरै	धेरै $	धे रै
उति	उति $	उ ति
प्रोत्साहनभत्ताको	प्रोत्साहनभत्ता को	प्रोत्साहनभत् ताको
बढ्छ	बढ्छ $	ब ढ्छ
जुनियर	जुनियर $	जु नियर
चिकित्सकले	चिकित्सक ले	चिकित्स कले
न्यूनतम	न्यूनतम $	न्यून तम
हजार	हजार $	ह जार
बरिष्ठ	बरिष्ठ $	बरि ष्ठ
चिकित्सकले	चिकित्सक ले	चिकित्स कले
लाखसम्म	लाख सम्म	लाख सम्म
पाइरहेका	पाइ रहेका	पा इरहेका
लाख	लाख $	ला ख
भन्दा	भन्दा $	भ न्दा
कम	कम $	क म
जनशक्ती	जनशक्ती $	जनशक् ती
पूर्वाधार	पूर्वाधार $	पूर्वा धार
न्यून	न्यून $	न् यून
बढी	बढी $	ब ढी
उती	उती $	उ ती
संसारभर	संसार भर	संसार भर
दैनिक	दैनिक $	दै निक
चिकित्सकले	चिकित्सक ले	चिकित्स कले
एउटा	एउटा $	एउ टा
बिरामीको	बिरामी को	बिरामी को
मुटुको	मुटु को	मुटु को
गर्ने	गर्ने $	गर् ने
अभ्यासलाई	अभ्यास लाई	अभ्या सलाई
लत्याउँदै	लत्याउँदै $	ल त्याउँदै
गंगालालले	गंगालाल ले	गंगाला लले
वटा	वटा $	व टा
सम्म	सम्म $	स म्म
गर्दै	गर्दै $	गर् दै
आइरहेको	आइ रहेको	आइ रहेको
अस्पतालको	अस्पताल को	अस् पतालको
विभागमा	विभाग मा	विभा गमा
जना	जना $	ज ना
दुई	दुई $	दु ई
यूनिटमा	यूनिट मा	यूनि टमा
बाँडिएका	बाँडिए का	बाँडि एका
यूनिटले	यूनिट ले	यू निटले
दिन	दिन $	दि न
बिराएर	बिराएर $	बिरा एर
गरेका	गरे का	गरे का
यूनिटमा	यूनिट मा	यूनि टमा
अर्कोमा	अर्को मा	अर् कोमा
जनाले	जना ले	जना ले
बिरामीलाई	बिरामी लाई	बिरा मीलाई
प्रयाप्त	प्रयाप्त $	प्रया प्त
समय	समय $	सम य
सम्भव	सम्भव $	स म्भव
स्रोत	स्रोत $	स्रो त
भन्छ	भन्छ $	भन् छ
हतारमा	हतार मा	ह तारमा
गरेकै	गरे कै	ग रेकै
अधिकांस	अधिकांस $	अधिकां स
बिरामीलाई	बिरामी लाई	बिरा मीलाई
संक्रमण	संक्रमण $	सं क्रमण
गरेको	गरे को	ग रेको
गरिन्छ	गरिन्छ $	गरि न्छ
गुमाउँछन्	गुमाउँछन् $	गुमा उँछन्
थोरै	थोरै $	थो रै
पूर्वाधारकाबिच	पूर्वाधारका बिच	पूर्वा धारकाबिच
बिरामीको	बिरामी को	बिरामी को
यसले	यस ले	यस ले
बिरामीलाई	बिरामी लाई	बिरा मीलाई
घाटा	घाटा $	घा टा
पुग्ने	पुग्ने $	पु ग्ने
गरेको	गरे को	ग रेको
चिकित्सकको	चिकित्सक को	चिकित्स कको
भनाई	भनाई $	भ नाई
अस्पतालमा	अस्पताल मा	अस् पतालमा
शल्यकक्ष	शल्यकक्ष $	शल्यक क्ष
चिकित्सकले	चिकित्सक ले	चिकित्स कले
तिनैवटा	तिनै वटा	तिनै वटा
कक्षमा	कक्ष मा	क क्षमा
गर्दापनि	गर्दा पनि	गर्दा पनि
भ्याउन	भ्याउन $	भ्या उन
जनाले	जना ले	ज नाले
बिरामीको	बिरामी को	बिरामी को
गर्नुपर्ने	गर्नु पर्ने	गर् नुपर्ने
हुन्छ	हुन्छ $	हु न्छ
झन्	झन् $	झ न्
चिकित्सकले	चिकित्सक ले	चिकित्स कले
कसरी	कसरी $	क सरी
भ्याउलान्	भ्याउलान् $	भ्या उलान्
भ्याइहाले	भ्याइहा ले	भ्या इहाले
त्यसपछि	त्यस पछि	त्यस पछि
व्यवस्थापन	व्यवस्थापन $	व्य वस्थापन
गर्नका	गर्न का	गर् नका
आवश्यक	आवश्यक $	आव श्यक
पर्ने	पर्ने $	प र्ने
आईसीयू	आईसीयू $	आई सीयू
नहुँदा	नहुँदा $	न हुँदा
बिरामीले	बिरामी ले	बिरा मीले
सास्ती	सास्ती $	सा स्ती
खेपिरहेका	खेपि रहेका	खे पिरहेका
बिरामीले	बिरामी ले	बिरा मीले
आईसीयूमा	आईसीयू मा	आई सीयूमा
बसेर	बसेर $	बसे र
बिशेष	बिशेष $	बि शेष
हेरचाह	हेरचाह $	हे रचाह
पाउँदैन	पाउँदैन $	पाउँ दैन
छिटै	छिटै $	छि टै
भएकै	भए कै	भ एकै
संक्रमणले	संक्रमण ले	संक्रम णले
घाउ	घाउ $	घा उ
पाकेर	पाकेर $	पा केर
धाइरहेका	धाइ रहेका	धा इरहेका
संक्रमणकै	संक्रमण कै	सं क्रमणकै
बिरामीको	बिरामी को	बिरामी को
मृत्युदर	मृत्युदर $	मृत्यु दर
बढेको	बढे को	ब ढेको
भक्तपुर	भक्तपुर $	भक् तपुर
नगरपालिकाले	नगरपालिका ले	नग रपालिकाले
सम्पदा	सम्पदा $	सम्प दा
संरक्षण	संरक्षण $	संरक्ष ण
तथा	तथा $	त था
विकास	विकास $	वि कास
निर्माणलाई	निर्माण लाई	निर्माण लाई
प्राथमिकतामा	प्राथमिकता मा	प्राथमिक तामा
राख्दै	राख्दै $	राख् दै
कुल	कुल $	कु ल
बजेटको	बजेट को	बजे टको
दशमलब	दशमलब $	दश मलब
प्रतिशत	प्रतिशत $	प् रतिशत
अर्थात्	अर्थात् $	अ र्थात्
करोड	करोड $	करो ड
रुपैयाँ	रुपैयाँ $	रु पैयाँ
छुट्याएको	छुट्याए को	छुट् याएको
भूकम्पले	भूकम्प ले	भू कम्पले
क्षतिग्रस्त	क्षतिग्रस्त $	क्षति ग्रस्त
मठमन्दिरको	मठमन्दिर को	मठमन्दि रको
पुनर्निर्माणलाई	पुनर्निर्माण लाई	पुन र्निर्माणलाई
प्राथमितामा	प्राथमिता मा	प्राथमि तामा
राखेर	राखेर $	रा खेर
बजेट	बजेट $	ब जेट
विनियोजन	विनियोजन $	विनियो जन
नगरप्रमुख	नगरप्रमुख $	नगरप् रमुख
सुनिल	सुनिल $	सुनि ल
प्रजापतिले	प्रजापति ले	प्रजा पतिले
बताए	बताए $	ब ताए
नगरपालिकाले	नगरपालिका ले	नग रपालिकाले
शिक्षालाई	शिक्षा लाई	शि क्षालाई
त्यसपछिको	त्यस पछिको	त्यस पछिको
प्राथमिकतामा	प्राथमिकता मा	प्राथमिकता मा
बजेटको	बजेट को	बजे टको
दशमलव	दशमलव $	दश मलव
छुट्याएको	छुट्याए को	छुट् याएको
स्वास्थ्यका	स्वास्थ्य का	स्वास्थ्य का
युवा	युवा $	यु वा
खेलकुदका	खेलकुद का	खेल कुदका
पर्यटन	पर्यटन $	पर् यटन
विकासका	विकास का	विकास का
महोत्सवका	महोत्सव का	म होत्सवका
फोहोरमैला	फोहोरमैला $	फो होरमैला
वातावरण	वातावरण $	वा तावरण
सुधारका	सुधार का	सुधा रका
नगरभित्रका	नगर भित्रका	नगरभि त्रका
सामुदायिक	सामुदायिक $	सामु दायिक
विद्यालयहरूमा	विद्यालय हरूमा	विद्यालय हरूमा
बालविकास	बालविकास $	बाल विकास
सहजकर्ता	सहज कर्ता	सहज कर्ता
ईसीडी	ईसीडी $	ईसी डी
शिक्षक	शिक्षक $	शिक् षक
हरूको	हरू को	ह रूको
कार्य	कार्य $	का र्य
मूल्यांकन	मूल्यांकन $	मूल् यांकन
गरी	गरी $	ग री
प्रतिव्यक्ति	प्रतिव्यक्ति $	प्रति व्यक्ति
प्रतिमहिना	प्रतिमहिना $	प्रति महिना
रुपैयाँका	रुपैयाँ का	रुपैयाँ का
दरले	दर ले	द रले
नगरपालिकाको	नगरपालिका को	नगरपा लिकाको
आफ्नै	आफ्नै $	आफ् नै
स्रोतबाट	स्रोत बाट	स्रोत बाट
व्यहोर्ने	व्यहोर्ने $	व्यहोर् ने
गरीबन्दोबस्त	गरीबन्दोबस्त $	गरी बन्दोबस्त
गरिएको	गरिए को	ग रिएको
जनाएको	जनाए को	ज नाएको
नगरपालिकाले	नगरपालिका ले	नग रपालिकाले
आगामी	आगामी $	आ गामी
आर्थिक	आर्थिक $	आर् थिक
वर्षका	वर्ष का	वर्ष का
अर्ब	अर्ब $	अर् ब
पेस	पेस $	पे स
गरेको	गरे को	ग रेको
नगरपालिकाको	नगरपालिका को	नगरपा लिकाको
पाँचौं	पाँचौं $	पाँ चौं
नगरसभामा	नगरसभा मा	नग रसभामा
उपप्रमुख	उपप्रमुख $	उपप् रमुख
रजनी	रजनी $	र जनी
जोशीले	जोशी ले	जो शीले
बजेटको	बजेट को	बजे टको
चालु	चालु $	चा लु
खर्चतर्फ	खर्च तर्फ	खर्च तर्फ
पुँजीगत	पुँजीगत $	पुँजी गत
खर्चतर्फ	खर्च तर्फ	खर्च तर्फ
गरेको	गरे को	ग रेको
जानकारी	जानकारी $	जा नकारी
दिइन्	दिइन् $	दि इन्
जसमध्ये	जस मध्ये	जस मध्ये
चालुतर्फ	चालु तर्फ	चालु तर्फ
खर्चका	खर्च का	खर्च का
पुँजीगततर्फ	पुँजीगत तर्फ	पुँजीगत तर्फ
गरेको	गरे को	गरे को
उनले	उन ले	उ नले
बताइन्	बताइन् $	बताइ न्
कमजोर	कमजोर $	क मजोर
भएका	भए का	भ एका
तर	तर $	त र
शैक्षिक	शैक्षिक $	शैक्षि क
स्तर	स्तर $	स् तर
राम्रो	राम्रो $	राम् रो
भएका	भए का	भ एका
जेहेनदार	जेहेनदार $	जेहेन दार
एवं	एवं $	ए वं
मेधावी	मेधावी $	मे धावी
विद्यार्थीहरूलाई	विद्यार्थी हरूलाई	विद्यार्थीहरू लाई
उच्च	उच्च $	उ च्च
शिक्षा	शिक्षा $	शि क्षा
हासिल	हासिल $	हा सिल
गर्न	गर्न $	ग र्न
सहयोग	सहयोग $	सहयो ग
हिसाबले	हिसाब ले	हिसा बले
नगरपालिकाले	नगरपालिका ले	नग रपालिकाले
ऋण	ऋण $	ऋ ण
कोषको	कोष को	को षको
गरेको	गरे को	ग रेको
उक्त	उक्त $	उक् त
कोषमा	कोष मा	को षमा
गरेको	गरे को	ग रेको
सांस्कृतिक	सांस्कृतिक $	सांस्कृ तिक
प्रवर्द्धनका	प्रवर्द्धन का	प्र वर्द्धनका
खानेपानी	खानेपानी $	खाने पानी
पाइप	पाइप $	पाइ प
सुधारका	सुधार का	सुधा रका
कृषि	कृषि $	कृ षि
पशु	पशु $	पशु 
सेवाका	सेवा का	सेवा का
जग्गा	जग्गा $	ज ग्गा
भवन	भवन $	भ वन
खरिदका	खरिद का	खरि दका
देको	दे को	दे को
मिवा	मिवा $	मि वा
इटापाके	इटापाके $	इ टापाके
एकीकरण	एकीकरण $	एकीक रण
आयोजनाका	आयोजना का	आयो जनाका
सवारीसाधन	सवारीसाधन $	स वारीसाधन
खरिदका	खरिद का	खरि दका
मेसिनरी	मेसिनरी $	मे सिनरी
औजार	औजार $	औ जार
खरिदका	खरिद का	खरि दका
अनुसन्धान	अनुसन्धान $	अ नुसन्धान
परामर्शका	परामर्श का	परा मर्शका
कोषका	कोष का	को षका
नगरपालिकाका	नगरपालिका का	नग रपालिकाका
कर्मचारीको	कर्मचारी को	कर्मचा रीको
खाजा	खाजा $	खा जा
खर्चबापत्	खर्चबापत् $	खर्च बापत्
सय	सय $	स य
गरेको	गरे को	ग रेको
त्यसैगरी	त्यसैगरी $	त्यसै गरी
रानीपोखरी	रानीपोखरी $	रा नीपोखरी
पार्क	पार्क $	पा र्क
निर्माण	निर्माण $	निर् माण
भैरवनाथ	भैरवनाथ $	भैरवना थ
मन्दिर	मन्दिर $	म न्दिर
भाज्या	भाज्या $	भा ज्या
पोखरी	पोखरी $	पोख री
जलेश्वर	जलेश्वर $	जलेश् वर
पुरानो	पुरानो $	पुरा नो
नगरपालिका	नगरपालि का	नग रपालिका
थंथु	थंथु $	थं थु
दरबार	दरबार $	दरबा र
पुनर्निर्माण	पुनर्निर्माण $	पुनर्नि र्माण
स्क्वायर	स्क्वायर $	स् क्वायर
न्यातपोल	न्यातपोल $	न्या तपोल
मर्मत	मर्मत $	मर् मत
नरसिंह	नरसिंह $	नर सिंह
गरेको	गरे को	गरे को
ख्वपः	ख्वपः $	ख् वपः
निर्माणका	निर्माण का	निर्मा णका
सिद्धपोखरी	सिद्धपोखरी $	सि द्धपोखरी
उत्तरतर्फको	उत्तर तर्फको	उत्तर तर्फको
खेलमैदान	खेलमैदान $	खेल मैदान
आकाशेपानी	आकाशेपानी $	आका शेपानी
संकलन	संकलन $	संक लन
औद्योगिक	औद्योगिक $	औ द्योगिक
क्षेत्रभित्र	क्षेत्र भित्र	क्षे त्रभित्र
केन्द्र	केन्द्र $	के न्द्र
अरनिको	अरनि को	अ रनिको
सभा	सभा $	स भा
निर्माणका	निर्माण का	निर्मा णका
गरेको	गरे को	ग रेको
आदर	आदर $	आ दर
निकेतन	निकेतन $	निके तन
सञ्चालन	सञ्चालन $	सञ्चा लन
कार्यका	कार्य का	कार्य का
गरेकोनगरप्रमुख	गरेकोनगरप्रमुख $	गरेको नगरप्रमुख
प्रजापतिले	प्रजापति ले	प्रजा पतिले
त्यस्तै	त्यस्तै $	त् यस्तै
सडक	सडक $	स डक
कालोपत्रे	कालोपत्रे $	कालो पत्रे
पार्किङ	पार्किङ $	पार् किङ
स्थल	स्थल $	स् थल
महेश्वरी	महेश्वरी $	म हेश्वरी
व्यवस्थापनका	व्यवस्थापन का	व्यवस्थाप नका
सहिद	सहिद $	स हिद
स्मृति	स्मृति $	स् मृति
संग्रहालयका	संग्रहालय का	संग्रहाल यका
कोसेली	कोसेली $	को सेली
घरका	घर का	घ रका
बधशाला	बधशाला $	ब धशाला
निर्माणका	निर्माण का	निर्मा णका
रुपैयाँविनियोजन	रुपैयाँविनियोजन $	रुपैयाँ विनियोजन
गरेको	गरे को	गरे को
उनले	उन ले	उ नले
भक्तपुरका	भक्तपुर का	भक्त पुरका
परम्परागत	परम्परागत $	प रम्परागत
विधाहरूलाई	विधा हरूलाई	विधा हरूलाई
जीवन्त	जीवन्त $	जीव न्त
बनाउन	बनाउन $	ब नाउन
सांस्कृतिकर्मी	सांस्कृतिकर्मी $	सांस्कृतिकर् मी
कलाकारहरूलाई	कलाकार हरूलाई	कलाकार हरूलाई
जीवन	जीवन $	जी वन
जिउने	जिउने $	जि उने
आधारका	आधार का	आधार का
रुपमा	रुप मा	रु पमा
प्रदर्शनी	प्रदर्शनी $	प्रदर्श नी
तयारीसहित	तयारी सहित	तयारी सहित
विनियेजन	विनियेजन $	विनिये जन
गरिएको	गरिए को	गरि एको
नगरबासीको	नगरबासी को	नग रबासीको
न्यूनीकरण	न्यूनीकरण $	न्यूनीक रण
नगरपालिकाको	नगरपालिका को	नगरपा लिकाको
तर्फबाट	तर्फ बाट	तर् फबाट
पहल	पहल $	पह ल
नगरका	नगर का	नग रका
ठाउँठाउँमा	ठाउँठाउँ मा	ठाउँ ठाउँमा
भूमिगत	भूमिगत $	भूमि गत
पानीको	पानी को	पा नीको
पहिचान	पहिचान $	प हिचान
खानेपानीको	खानेपानी को	खाने पानीको
खानेपानीको	खानेपानी को	खाने पानीको
सुधारका	सुधार का	सुधा रका
गरिएको	गरिए को	ग रिएको
स्थित	स्थित $	स्थि त
ऐतिहासिक	ऐतिहासिक $	ऐतिहा सिक
पोखरीको	पोखरी को	पो खरीको
मध्यभागमा	मध्यभाग मा	मध्य भागमा
अवस्थित	अवस्थित $	अवस् थित
मन्दिरलाई	मन्दिर लाई	मन्दिर लाई
मौलिक	मौलिक $	मौ लिक
शैलीमा	शैली मा	शै लीमा
गरिएको	गरिए को	ग रिएको
सैनिक	सैनिक $	सैनि क
आवासीय	आवासीय $	आवा सीय
महाविद्यालय	महाविद्यालय $	महावि द्यालय
परिसरभित्र	परिसर भित्र	परिस रभित्र
रहेको	रहे को	रहे को
पुरातात्त्विक	पुरातात्त्विक $	पुरा तात्त्विक
महत्त्वको	महत्त्व को	महत् त्वको
कार्यलाई	कार्य लाई	कार्य लाई
निरन्तरता	निरन्तरता $	नि रन्तरता
दिने	दिने $	दि ने
बजेटमा	बजेट मा	बजे टमा
उल्लेख	उल्लेख $	उल्ले ख
सर्वसाधारण	सर्वसाधारण $	सर्वसा धारण
जनताका	जनता का	जनता का
खुला	खुला $	खु ला
पोखरीको	पोखरी को	पो खरीको
दक्षिणतिर	दक्षिण तिर	दक्षिण तिर
पार्किङको	पार्किङ को	पार् किङको
सहमति	सहमति $	सह मति
नगरपालिका	नगरपालि का	नग रपालिका
नेपाली	नेपाली $	नेपा ली
सेनाबीच	सेना बीच	सेना बीच
भएको	भए को	भए को
क्षेत्रलाई	क्षेत्र लाई	क्षे त्रलाई
साना	साना $	सा ना
घरेलु	घरेलु $	घ रेलु
उद्योगमा	उद्योग मा	उद् योगमा
आधारित	आधारित $	आधारि त
वातावरणमैत्री	वातावरणमैत्री $	वातावरण मैत्री
पर्यटकीय	पर्यटकीय $	पर् यटकीय
योजना	योजना $	योज ना
बजेटमा	बजेट मा	बजे टमा
दरबारक्षेत्र	दरबारक्षेत्र $	दरबार क्षेत्र
परिसरमा	परिसर मा	परि सरमा
जनज्योति	जनज्योति $	जन ज्योति
पुस्तकालय	पुस्तकालय $	पुस्त कालय
रहेको	रहे को	र हेको
भवनलाई	भवन लाई	भ वनलाई
स्तरोन्नति	स्तरोन्नति $	स्त रोन्नति
आन्तरिक	आन्तरिक $	आन् तरिक
बाह्य	बाह्य $	बा ह्य
पर्यटकका	पर्यटक का	पर् यटकका
पसः	पसः $	प सः
कार्यक्रमसहित	कार्यक्रम सहित	कार्यक्रम सहित
गरिएको	गरिए को	ग रिएको
बजेटमा	बजेट मा	बजे टमा
सुधार	सुधार $	सु धार
व्यवस्थित	व्यवस्थित $	व्यवस् थित
कभर्ड	कभर्ड $	क भर्ड
हल	हल $	ह ल
बाल	बाल $	बा ल
उद्यान	उद्यान $	उद् यान
वडा	वडा $	व डा
वडामा	वडा मा	व डामा
शारीरिक	शारीरिक $	शा रीरिक
व्यायाम	व्यायाम $	व्या याम
विस्तार	विस्तार $	विस् तार
वर्ष	वर्ष $	वर् ष
नगरपालिकाले	नगरपालिका ले	नग रपालिकाले
नगरबासी	नगर बासी	नग रबासी
ज्येष्ठ	ज्येष्ठ $	ज्ये ष्ठ
नागरिकका	नागरिक का	ना गरिकका
अलग्गै	अलग्गै $	अ लग्गै
बजेटको	बजेट को	बजे टको
गरिएको	गरिए को	गरिए को
किसानको	किसान को	किसा नको
उत्पादनलाई	उत्पादन लाई	उत्पाद नलाई
रुपमा	रुप मा	रु पमा
सुपथ	सुपथ $	सु पथ
मूल्यमा	मूल्य मा	मूल् यमा
बिक्री	बिक्री $	बिक् री
वितरण	वितरण $	वित रण
उपभोक्ता	उपभोक्ता $	उपभो क्ता
हितमा	हित मा	हि तमा
तरकारी	तरकारी $	तर कारी
बजार	बजार $	बजा र
गर्नेसमेत	गर्ने समेत	गर्ने समेत
बजेटमा	बजेट मा	बजे टमा
नगरपालिकाले	नगरपालिका ले	नग रपालिकाले
आधुनिक	आधुनिक $	आधु निक
सुविधा	सुविधा $	सु विधा
सम्पन्न	सम्पन्न $	सम् पन्न
अरनिको	अरनि को	अ रनिको
सभाभवनको	सभाभवन को	सभाभ वनको
विस्तृत	विस्तृत $	विस् तृत
डिजाइन	डिजाइन $	डिजा इन
लागत	लागत $	ला गत
इस्टिमेट	इस्टिमेट $	इस् टिमेट
तयार	तयार $	त यार
भएको	भए को	भ एको
वर्षमा	वर्ष मा	व र्षमा
थालनी	थालनी $	था लनी
गरेको	गरे को	ग रेको
नगरको	नगर को	नग रको
सुरक्षा	सुरक्षा $	सु रक्षा
व्यवस्थालाई	व्यवस्था लाई	व्यवस्था लाई
चुस्त	चुस्त $	चु स्त
प्रभावकारी	प्रभावकारी $	प्रभाव कारी
चोक	चोक $	चो क
गल्ली	गल्ली $	ग ल्ली
क्षेत्रमा	क्षेत्र मा	क्षेत्र मा
सीसीक्यामेरा	सीसीक्यामेरा $	सी सीक्यामेरा
रात्रिकालीन	रात्रिकालीन $	रात्रि कालीन
बत्तीको	बत्ती को	बत् तीको
बजेटमा	बजेट मा	बजे टमा
सूर्यविनायकको	सूर्यविनायक को	सूर्य विनायकको
सूर्यविनायक	सूर्यविनायक $	सूर्य विनायक
नगरपालिकाले	नगरपालिका ले	नग रपालिकाले
रुपैयाँको	रुपैयाँ को	रु पैयाँको
प्रस्तुत	प्रस्तुत $	प् रस्तुत
गरेको	गरे को	ग रेको
नगरपालिकाको	नगरपालिका को	नगरपा लिकाको
नगरसभामा	नगरसभा मा	नग रसभामा
जुना	जुना $	जु ना
बस्नेतले	बस्नेत ले	बस्नेत ले
चालुतर्फ	चालु तर्फ	चालु तर्फ
सामाजिक	सामाजिक $	सामा जिक
सुरक्षातर्फ	सुरक्षा तर्फ	सुरक्षा तर्फ
विषयगत	विषयगत $	विष यगत
शाखातर्फ	शाखा तर्फ	शाखा तर्फ
ससर्त	ससर्त $	स सर्त
कार्यका	कार्य का	कार्य का
पंुँजीगततर्फ	पंुँजीगत तर्फ	पंुँजीगत तर्फ
करोडको	करोड को	करो डको
गरेकी	गरे की	गरे की
बस्नेतले	बस्नेत ले	बस्नेत ले
गरेको	गरे को	गरे को
बजेटमा	बजेट मा	बजे टमा
नगरपालिकाको	नगरपालिका को	नगरपा लिकाको
स्रोतबाट	स्रोत बाट	स्रो तबाट
आम्दानी	आम्दानी $	आ म्दानी
अनुमान	अनुमान $	अनु मान
गरेको	गरे को	गरे को
प्रदेश	प्रदेश $	प्र देश
सरकारको	सरकार को	स रकारको
समानीकरण	समानीकरण $	समा नीकरण
अनुदानतर्फ	अनुदान तर्फ	अनुदान तर्फ
सरकारको	सरकार को	सरका रको
अनुदानबाट	अनुदान बाट	अनुदान बाट
नेपाल	नेपाल $	नेपा ल
सरकारको	सरकार को	सरकार को
अनुदानतर्फ	अनुदान तर्फ	अनुदान तर्फ
सरकारको	सरकार को	सरकार को
अनुदानबाट	अनुदान बाट	अनुदान बाट
प्राप्त	प्राप्त $	प् राप्त
गरेको	गरे को	ग रेको
वक्तव्यमा	वक्तव्य मा	वक्तव् यमा
सरकारको	सरकार को	सरकार को
राजस्व	राजस्व $	रा जस्व
बाँडफाँडको	बाँडफाँड को	बाँडफाँ डको
स्रोतबाट	स्रोत बाट	स्रो तबाट
आय	आय $	आ य
गरिएको	गरिए को	गरि एको
वर्षको	वर्ष को	व र्षको
तुलनामा	तुलना मा	तुलना मा
प्रतिशतले	प्रतिशत ले	प् रतिशतले
भएको	भए को	भए को
उनले	उन ले	उ नले
लोकसेवा	लोकसेवा $	लोक सेवा
आयोगको	आयोग को	आयोग को
विज्ञापनमा	विज्ञापन मा	विज्ञापन मा
आरक्षणको	आरक्षण को	आर क्षणको
कार्यान्वयन	कार्यान्वयन $	कार्यान्व यन
हुनुपर्ने	हुनु पर्ने	हुनुपर् ने
भन्दै	भन्दै $	भन् दै
सरोकार	सरोकार $	सरो कार
पक्षले	पक्ष ले	पक्ष ले
बुधबार	बुधबार $	बु धबार
माइतीघर	माइतीघर $	माइ तीघर
मण्डलामा	मण्डला मा	मण्ड लामा
धर्ना	धर्ना $	धर् ना
दिएका	दिए का	दिए का
स्थानीय	स्थानीय $	स् थानीय
तहमा	तह मा	त हमा
करारमा	करार मा	करा रमा
कर्मचारी	कर्मचारी $	कर्म चारी
राख्न	राख्न $	राख् न
नहुनेसमेत	नहुने समेत	नहुने समेत
उनीहरुले	उनी हरुले	उ नीहरुले
भनेका	भने का	भ नेका
हामी	हामी $	हा मी
अपांगता	अपांगता $	अ पांगता
भएकाहरूको	भएका हरूको	भएका हरूको
बिजोग	बिजोग $	बि जोग
देखाउने	देखाउने $	देखा उने
रहरले	रहर ले	रह रले
टन्टलापुर	टन्टलापुर $	टन्टला पुर
घाममा	घाम मा	घा ममा
मण्डलामा	मण्डला मा	मण्ड लामा
आएका	आए का	आ एका
होइनौं	होइनौं $	होइ नौं
अपांग	अपांग $	अ पांग
महासंघ	महासंघ $	महा संघ
नेपालकी	नेपाल की	नेपाल की
उपाध्यक्ष	उपाध्यक्ष $	उपा ध्यक्ष
रमा	रमा $	र मा
ढकालले	ढकाल ले	ढकाल ले
भनिन्	भनिन् $	भनि न्
संविधानमा	संविधान मा	संविधा नमा
लेखिएको	लेखिए को	लेखिए को
समानुपातिक	समानुपातिक $	समा नुपातिक
समावेशी	समावेशी $	समावे शी
आरक्षणको	आरक्षण को	आर क्षणको
विषयलाई	विषय लाई	विषय लाई
हुनुपर्छ	हुनुपर्छ $	हुनुपर् छ
भन्नेमात्रै	भन्ने मात्रै	भन्ने मात्रै
हाम्रो	हाम्रो $	हाम् रो
माग	माग $	मा ग
प्रहरीले	प्रहरी ले	प्र हरीले
मण्डला	मण्डला $	म ण्डला
क्षेत्रमा	क्षेत्र मा	क् षेत्रमा
बस्न	बस्न $	ब स्न
नदिएपछि	नदिए पछि	नदि एपछि
उनीहरु	उनी हरु	उनीह रु
पूर्वतर्फ	पूर्वतर्फ $	पूर्व तर्फ
खाली	खाली $	खा ली
भागमा	भाग मा	भा गमा
बसेका	बसे का	ब सेका
भएकाहरूले	भएका हरूले	भएका हरूले
सडकमै	सडक मै	सड कमै
बैसाखी	बैसाखी $	बैसा खी
तेर्स्याएका	तेर्स्याए का	तेर्स्या एका
थिए	थिए $	थि ए
तीनपांग्रे	तीनपांग्रे $	ती नपांग्रे
स्कुटर	स्कुटर $	स्कु टर
बिसाएका	बिसाए का	बिसा एका
ह्वील	ह्वील $	ह् वील
चियर	चियर $	चि यर
बिसाएका	बिसाए का	बिसा एका
सेतो	सेतो $	से तो
छडीवालाहरू	छडीवाला हरू	छडीवाला हरू
उभिएरै	उभिएरै $	उभिए रै
मागका	माग का	माग का
नारा	नारा $	ना रा
लगाइरहेका	लगाइ रहेका	लगा इरहेका
भएकाहरूसँगै	भएका हरूसँगै	भएका हरूसँगै
आदिवासी	आदिवासी $	आदि वासी
जनजाति	जनजाति $	जन जाति
महिला	महिला $	महि ला
दलित	दलित $	द लित
मधेसी	मधेसी $	म धेसी
थारु	थारु $	था रु
मुस्लिम	मुस्लिम $	मुस् लिम
अल्पसंख्यकका	अल्पसंख्यक का	अल्प संख्यकका
प्रतिनिधिहरू	प्रतिनिधि हरू	प्रति निधिहरू
सहभागी	सहभागी $	सहभा गी
संविधानप्रदत्त	संविधानप्रदत्त $	संविधानप्र दत्त
समावेशिता	समावेशिता $	समावे शिता
सुनिश्चित	सुनिश्चित $	सुनि श्चित
गर	गर $	ग र
बहिष्कृत	बहिष्कृत $	बहिष् कृत
समुदायका	समुदाय का	समु दायका
आरक्षण	आरक्षण $	आर क्षण
राज्य	राज्य $	राज् य
सुशासन	सुशासन $	सुशा सन
समितिको	समिति को	समि तिको
निर्देशन	निर्देशन $	निर्देश न
पालना	पालना $	पाल ना
आरक्षणसहितको	आरक्षणसहित को	आरक्षण सहितको
विज्ञापन	विज्ञापन $	विज्ञा पन
पुनः	पुनः $	पु नः
प्रकाशित	प्रकाशित $	प्र काशित
आरक्षणभित्र	आरक्षण भित्र	आरक्षण भित्र
समावेशितालाई	समावेशिता लाई	समावे शितालाई
करार	करार $	क रार
भर्ती	भर्ती $	भ र्ती
मान्दैनौं	मान्दैनौं $	मान् दैनौं
जस्ता	जस्ता $	ज स्ता
चर्को	चर्को $	चर् को
लगाएका	लगाए का	लगा एका
लोक	लोक $	लो क
सेवा	सेवा $	से वा
आयोगले	आयोग ले	आयोग ले
तहहरूमा	तह हरूमा	तह हरूमा
रिक्त	रिक्त $	रि क्त
प्राविधिक	प्राविधिक $	प्रा विधिक
अप्राविधिक	अप्राविधिक $	अप् राविधिक
पदका	पद का	प दका
निम्ति	निम्ति $	नि म्ति
पदपूर्ति	पदपूर्ति $	पद पूर्ति
आह्वान	आह्वान $	आ ह्वान
गरेको	गरे को	गरे को
हटाएको	हटाए को	ह टाएको
यसरी	यसरी $	य सरी
आन्दोलन	आन्दोलन $	आन् दोलन
गर्दैआएका	गर्दैआए का	गर्दै आएका
संयुक्त	संयुक्त $	संयु क्त
बचाऔं	बचाऔं $	ब चाऔं
भएका	भए का	भ एका
व्यक्ति	व्यक्ति $	व्य क्ति
पिछडिएको	पिछडिए को	पिछडि एको
क्षेत्रका	क्षेत्र का	क्षे त्रका
प्रतिनिधि	प्रतिनिधि $	प्रति निधि
सरकारको	सरकार को	सरकार को
विरुद्धमा	विरुद्ध मा	वि रुद्धमा
होइन	होइन $	होइ न
संविधान	संविधान $	संवि धान
कार्यान्वयको	कार्यान्वय को	कार्यान्व यको
पक्षमा	पक्ष मा	प क्षमा
उभिएका	उभिए का	उभि एका
महासंघका	महासंघ का	महा संघका
अध्यक्ष	अध्यक्ष $	अ ध्यक्ष
जगतबहादुर	जगतबहादुर $	जगत बहादुर
बरामले	बराम ले	बराम ले
अपिलपत्रमार्फत	अपिलपत्र मार्फत	अ पिलपत्रमार्फत
हामीले	हामी ले	हामी ले
ऐन	ऐन $	ऐ न
कानुनविपरीत	कानुनविपरीत $	कानुन विपरीत
बदनियतपूर्वक	बदनियत पूर्वक	बदनियत पूर्वक
गरिएको	गरिए को	गरिए को
विज्ञापनलाई	विज्ञापन लाई	विज्ञाप नलाई
तुरुन्त	तुरुन्त $	तुरु न्त
फिर्ता	फिर्ता $	फि र्ता
लिन	लिन $	लि न
सरकारसित	सरकार सित	सरकार सित
आग्रह	आग्रह $	आ ग्रह
गर्दछौं	गर्दछौं $	गर्द छौं
सिद्धान्त	सिद्धान्त $	सिद्धा न्त
बमोजिम	बमोजिम $	ब मोजिम
आरक्षणको	आरक्षण को	आर क्षणको
नभएसम्म	नभए सम्म	नभए सम्म
चरणवद्ध	चरणवद्ध $	चरण वद्ध
जारी	जारी $	जा री
रहने	रहने $	र हने
बरामले	बराम ले	बराम ले
भिडियो	भिडियो $	भि डियो
प्रतिनिधिसभा	प्रतिनिधिसभा $	प्रति निधिसभा
प्रविधि	प्रविधि $	प्र विधि
समितिले	समिति ले	समि तिले
गन्तव्य	गन्तव्य $	गन्त व्य
नगरकोट	नगरकोट $	नग रकोट
जाने	जाने $	जा ने
ठेकेदारको	ठेकेदार को	ठेकेदा रको
लापारबाहीले	लापारबाही ले	ला पारबाहीले
अलपत्र	अलपत्र $	अल पत्र
भएको	भए को	भ एको
औंल्याउँदै	औंल्याउँदै $	औंल्याउँ दै
समयमै	समय मै	सम यमै
दिएको	दिए को	दिए को
समितिकी	समिति की	स मितिकी
सभापति	सभापति $	सभा पति
कल्याणीकुमारीखड्कासहित	कल्याणीकुमारीखड्का सहित	कल्या णीकुमारीखड्कासहित
सांसदहरूको	सांसद हरूको	सांसद हरूको
टोलीले	टोली ले	टो लीले
आइतबार	आइतबार $	आइ तबार
स्थलगत	स्थलगत $	स्थ लगत
अनुगमन	अनुगमन $	अनु गमन
विस्तारमा	विस्तार मा	विस् तारमा
ठेकेदारले	ठेकेदार ले	ठेकेदा रले
ढिलाइ	ढिलाइ $	ढि लाइ
लापारबाही	लापारबाही $	लापा रबाही
गरेको	गरे को	ग रेको
निष्कर्ष	निष्कर्ष $	नि ष्कर्ष
निकालेको	निकाले को	निका लेको
खड्काको	खड्का को	खड् काको
नेतृत्वमा	नेतृत्व मा	नेतृत्व मा
समितिका	समिति का	स मितिका
सदस्यहरू	सदस्य हरू	सद स्यहरू
क्षेत्र	क्षेत्र $	क्षेत् र
नम्बर	नम्बर $	नम् बर
सदस्य	सदस्य $	स दस्य
महेश	महेश $	म हेश
बस्नेत	बस्नेत $	बस्ने त
प्रमुख	प्रमुख $	प्र मुख
जिल्ला	जिल्ला $	जिल् ला
अधिकारी	अधिकारी $	अ धिकारी
नारायणप्रसाद	नारायणप्रसाद $	नारायण प्रसाद
भट्ट	भट्ट $	भ ट्ट
चाँगुनारायण	चाँगुनारायण $	चाँगुना रायण
सोमप्रसाद	सोमप्रसाद $	सो मप्रसाद
मिश्र	मिश्र $	मिश् र
प्रहरी	प्रहरी $	प्र हरी
एसपी	एसपी $	एस पी
सबिन	सबिन $	स बिन
प्रधान	प्रधान $	प्रधा न
नगरउपप्रमुख	नगरउपप्रमुख $	नगरउपप् रमुख
जनप्रतिनिधि	जनप्रतिनिधि $	जन प्रतिनिधि
स्थानीयले	स्थानीय ले	स्थानी यले
सडकको	सडक को	सड कको
गरेका	गरे का	ग रेका
निर्माणाधीन	निर्माणाधीन $	निर्मा णाधीन
सडकको	सडक को	स डकको
क्रममा	क्रम मा	क् रममा
खड्काले	खड्का ले	खड् काले
कमिसनको	कमिसन को	कमिस नको
खेलमा	खेल मा	खे लमा
आयोजना	आयोजना $	आ योजना
परेको	परे को	परे को
अनुगमनफछि	अनुगमनफछि $	अनु गमनफछि
नगरकोटमा	नगरकोट मा	नग रकोटमा
आयोजित	आयोजित $	आयो जित
अन्तर्त्रिया	अन्तर्त्रिया $	अन्तर् त्रिया
कार्यक्रममा	कार्यक्रम मा	कार्य क्रममा
उनले	उन ले	उ नले
पूर्वतयारी	पूर्वतयारी $	पूर् वतयारी
पर्याप्त	पर्याप्त $	पर् याप्त
अध्ययन	अध्ययन $	अध्य यन
नभई	नभई $	नभ ई
ठेक्का	ठेक्का $	ठेक् का
हुनुले	हुनु ले	हुनु ले
काममा	काम मा	का ममा
लापरबाही	लापरबाही $	लाप रबाही
गरेको	गरे को	ग रेको
समयमै	समय मै	सम यमै
नगर्ने	नगर्ने $	नगर् ने
ठेकेदार	ठेकेदार $	ठेके दार
कम्पनीको	कम्पनी को	कम् पनीको
कार्यप्रगति	कार्यप्रगति $	कार्य प्रगति
चौमासिक	चौमासिक $	चौमा सिक
कार्ययोजनासहित	कार्ययोजना सहित	कार्य योजनासहित
समितिमा	समिति मा	समि तिमा
उनले	उन ले	उ नले
दिएकी	दिए की	दिए की
आउँदो	आउँदो $	आउँ दो
भ्रमण	भ्रमण $	भ्र मण
लाई	लाई $	ला ई
प्रभावित	प्रभावित $	प्रभा वित
नहुने	नहुने $	नहु ने
समयमै	समय मै	सम यमै
सडकको	सडक को	सडक को
सक्न	सक्न $	सक् न
उनले	उन ले	उ नले
सम्बद्ध	सम्बद्ध $	सम्ब द्ध
निकायलाई	निकाय लाई	निका यलाई
निर्देशनसमेत	निर्देशन समेत	निर्देश नसमेत
कार्यक्रममा	कार्यक्रम मा	का र्यक्रममा
बस्नेतले	बस्नेत ले	बस्नेत ले
समयमा	समय मा	स मयमा
जनस्तरबाट	जनस्तर बाट	जनस्त रबाट
निरन्तर	निरन्तर $	नि रन्तर
खबदारी	खबदारी $	खब दारी
हुँदा	हुँदा $	हुँ दा
सुनुवाइ	सुनुवाइ $	सु नुवाइ
नभएकाले	नभएका ले	नभए काले
संसदीय	संसदीय $	सं सदीय
समिति	समिति $	स मिति
गुहार्नुपरेको	गुहार्नुपरे को	गुहार्नु परेको
सार्क	सार्क $	सा र्क
सम्मेलन	सम्मेलन $	सम् मेलन
बिमस्टेक	बिमस्टेक $	बि मस्टेक
सम्मेलनमा	सम्मेलन मा	सम्मे लनमा
बाटाकै	बाटा कै	बा टाकै
अतिथिलाई	अतिथि लाई	अति थिलाई
स्वागत	स्वागत $	स्वा गत
सकिएन	सकिएन $	स किएन
अब	अब $	अ ब
नगुमोस्	नगुमोस् $	न गुमोस्
ढिलाइले	ढिलाइ ले	ढि लाइले
भएको	भए को	भए को
सन्दर्भ	सन्दर्भ $	सन् दर्भ
बस्नेतले	बस्नेत ले	बस्ने तले
जनस्तरको	जनस्तर को	जनस् तरको
पटकको	पटक को	पटक को
दबाब	दबाब $	द बाब
निर्णायक	निर्णायक $	निर् णायक
उनले	उन ले	उ नले
कम्पनीलाई	कम्पनी लाई	कम् पनीलाई
कारबाही	कारबाही $	कारबा ही
हुनुपर्ने	हुनु पर्ने	हु नुपर्ने
मागसमेत	माग समेत	माग समेत
गरे	गरे $	ग रे
विस्तारको	विस्तार को	विस्तार को
जिम्मेवारी	जिम्मेवारी $	जिम्मेवा री
शैलुङ	शैलुङ $	शै लुङ
कन्स्ट्रक्सनसहितले	कन्स्ट्रक्सनसहित ले	कन्स्ट्रक्सनसहि तले
लिएको	लिए को	लिए को
कार्यक्रममा	कार्यक्रम मा	का र्यक्रममा
समितिका	समिति का	स मितिका
सांसदहरू	सांसद हरू	सांस दहरू
गणेश	गणेश $	ग णेश
पहाडी	पहाडी $	प हाडी
रामबहादुर	रामबहादुर $	राम बहादुर
विष्ट	विष्ट $	वि ष्ट
यज्ञराज	यज्ञराज $	यज्ञ राज
सुनुवारलगायतले	सुनुवार लगायतले	सुनुवारलगाय तले
समयमा	समय मा	सम यमा
नसक्ने	नसक्ने $	नस क्ने
ठेकेदारलाई	ठेकेदार लाई	ठेकेदा रलाई
हुनुपर्ने	हुनु पर्ने	हुनुपर् ने
धारणा	धारणा $	धार णा
राखे	राखे $	रा खे
कार्यक्रममा	कार्यक्रम मा	कार्य क्रममा
अनुगमनका	अनुगमन का	अनु गमनका
क्रममा	क्रम मा	क् रममा
स्थानीयले	स्थानीय ले	स्थानी यले
समयमै	समय मै	सम यमै
बाटो	बाटो $	बा टो
निर्माणकार्य	निर्माणकार्य $	निर्माण कार्य
हिलो	हिलो $	हि लो
धूलोको	धूलो को	धू लोको
खेप्नुपरेको	खेप्नुपरे को	खेप्नु परेको
आक्रोश	आक्रोश $	आक् रोश
पोखेका	पोखे का	पो खेका
प्रयोगकर्ता	प्रयोग कर्ता	प्रयोग कर्ता
स्थानीयले	स्थानीय ले	स्थानीय ले
काटेको	काटे को	का टेको
होला	होला $	हो ला
पर्यटक	पर्यटक $	पर् यटक
ल्याउने	ल्याउने $	ल्याउ ने
यही	यही $	य ही
सडकपीडित	सडकपीडित $	सडक पीडित
संयोजक	संयोजक $	सं योजक
राजकुमार	राजकुमार $	राज कुमार
लामिछानेले	लामिछाने ले	लामिछा नेले
सांसदहरूलाई	सांसद हरूलाई	सांस दहरूलाई
प्रश्न	प्रश्न $	प्र श्न
टिपरको	टिपर को	टिप रको
पछाडि	पछाडि $	प छाडि
धूलोमा	धूलो मा	धूलो मा
वर्षादी	वर्षादी $	वर् षादी
ओढेर	ओढेर $	ओ ढेर
हिँड्ने	हिँड्ने $	हिँ ड्ने
सडकसँगैको	सडकसँगै को	सडक सँगैको
राजकुलोको	राजकुलो को	राज कुलोको
क्षति	क्षति $	क्ष ति
धुलोका	धुलो का	धुलो का
स्वास्थ्यमा	स्वास्थ्य मा	स्वास्थ्य मा
परेको	परे को	प रेको
असर	असर $	अस र
बालीनालीको	बालीनाली को	बालीना लीको
क्षतिपूर्तिको	क्षतिपूर्ति को	क्षति पूर्तिको
जिम्मा	जिम्मा $	जिम् मा
ठेकेदारले	ठेकेदार ले	ठेकेदा रले
लिनुपर्छ	लिनुपर्छ $	लिनु पर्छ
भन्दैउनले	भन्दैउन ले	भन्दै उनले
गुनासो	गुनासो $	गु नासो
व्यक्त	व्यक्त $	व्यक् त
गरेका	गरे का	गरे का
वर्षमा	वर्ष मा	व र्षमा
नगरकोटको	नगरकोट को	नग रकोटको
विस्तारका	विस्तार का	विस्तार का
तीनपल्ट	तीनपल्ट $	तीन पल्ट
म्याद	म्याद $	म्या द
कामको	काम को	का मको
गतिमा	गति मा	गति मा
खासै	खासै $	खा सै
घुम्न	घुम्न $	घु म्न
बासिन्दाले	बासिन्दा ले	बा सिन्दाले
घाम	घाम $	घा म
लाग्दा	लाग्दा $	लाग् दा
धूलो	धूलो $	धू लो
परे	परे $	प रे
हिलाम्य	हिलाम्य $	हि लाम्य
सडकका	सडक का	सडक का
बेहोर्दै	बेहोर्दै $	बेहो र्दै
आएका	आए का	आ एका
लागे	लागे $	ला गे
दिनेश	दिनेश $	दिने श
लामिछानेले	लामिछाने ले	लामिछा नेले
प्रतिप्रश्न	प्रतिप्रश्न $	प्रति प्रश्न
खाल्डाखुल्डी	खाल्डाखुल्डी $	खा ल्डाखुल्डी
सडकमा	सडक मा	सड कमा
ज्यानको	ज्यान को	ज्यान को
बाजी	बाजी $	बा जी
थापेर	थापेर $	था पेर
यात्रा	यात्रा $	या त्रा
गरौं	गरौं $	ग रौं
धुलाम्य	धुलाम्य $	धुलाम् य
सडकका	सडक का	सडक का
स्थानीयले	स्थानीय ले	स्थानीय ले
भोगेको	भोगे को	भो गेको
असरको	असर को	अस रको
क्षतिपूर्ति	क्षतिपूर्ति $	क्षति पूर्ति
कसले	कस ले	कस ले
तिर्छ	तिर्छ $	ति र्छ
उनले	उन ले	उ नले
सन	सन $	स न
सम्झौता	सम्झौता $	स म्झौता
भई	भई $	भ ई
जुनसम्म	जुन सम्म	जुन सम्म
गरिसक्ने	गरिसक्ने $	गरि सक्ने
लक्ष्यसहित	लक्ष्य सहित	लक्ष्य सहित
विस्तारको	विस्तार को	विस्तार को
लिएका	लिए का	लि एका
आरामाली	आरामाली $	आरा माली
इन्फ्रा	इन्फ्रा $	इन् फ्रा
पावर	पावर $	पाव र
लिमिडेट	लिमिडेट $	लिमि डेट
कन्स्ट्रसन	कन्स्ट्रसन $	कन्स्ट्र सन
कम्पनी	कम्पनी $	कम् पनी
प्रालिले	प्रालि ले	प्रा लिले
तीन	तीन $	ती न
पटक	पटक $	पट क
बल्ल	बल्ल $	ब ल्ल
सकाएको	सकाए को	सका एको
भक्तपुर–नगरकोट–सिपाघाट	भक्तपुर–नगरकोट–सिपाघाट $	भक् तपुर–नगरकोट–सिपाघाट
जगत	जगत $	जग त
प्रजापतिले	प्रजापति ले	प्रजा पतिले
लागेको	लागे को	लागे को
महिनासम्म	महिना सम्म	महि नासम्म
रूख	रूख $	रू ख
काट्न	काट्न $	का ट्न
भएको	भए को	भ एको
लगायत	लगायत $	ल गायत
देखाएर	देखाएर $	देखाए र
विस्तारको	विस्तार को	विस्तार को
लिएको	लिए को	लि एको
ठेकेदारले	ठेकेदार ले	ठेकेदा रले
जुनसम्म	जुन सम्म	जुन सम्म
गराएको	गराए को	गरा एको
हालसम्म	हाल सम्म	हाल सम्म
भएको	भए को	भ एको
कम्पनीले	कम्पनी ले	कम् पनीले
विभिन्न	विभिन्न $	विभिन् न
देखाउँदै	देखाउँदै $	देखाउँ दै
अझै	अझै $	अ झै
म्यादथपको	म्यादथप को	म्या दथपको
खोजिरहेका	खोजि रहेका	खोजि रहेका
एक्जिम	एक्जिम $	एक् जिम
बैंक	बैंक $	बैं क
इन्डिया	इन्डिया $	इन् डिया
सहयोगमा	सहयोग मा	स हयोगमा
कर	कर $	क र
सहित	सहित $	स हित
लागतमा	लागत मा	लाग तमा
थालिएको	थालिए को	थालिए को
वर्षअघि	वर्ष अघि	वर् षअघि
थालिएको	थालिए को	थालिए को
कमलविनायक	कमलविनायक $	कम लविनायक
भत्केको	भत्के को	भत् केको
पाटी–नगरकोट	पाटी–नगरकोट $	पा टी–नगरकोट
खण्डको	खण्ड को	खण्ड को
करिब	करिब $	क रिब
किलोमिटर	किलोमिटर $	किलो मिटर
ढिलाइसँगै	ढिलाइ सँगै	ढिलाइ सँगै
ठेकेदारको	ठेकेदार को	ठेकेदा रको
लापरबाहीका	लापरबाही का	ला परबाहीका
किनारामा	किनारा मा	किना रामा
लगाएको	लगाए को	लगा एको
नाली	नाली $	ना ली
पर्खाल	पर्खाल $	पर् खाल
भत्किसकेको	भत्कि सकेको	भत्कि सकेको
कमलविनायक–बाँसबारीसम्म	कमलविनायक–बाँसबारीसम्म $	कमलविनायक–बाँसबारी सम्म
गरेको	गरे को	ग रेको
कालोपत्रेसमेत	कालोपत्रे समेत	कालोपत्रे समेत
उक्किएर	उक्किएर $	उक् किएर
खाडल	खाडल $	खा डल
पर्न	पर्न $	पर् न
थालेको	थाले को	थाले को
विस्तारका	विस्तार का	विस्तार का
नाममा	नाम मा	ना ममा
नगरकोटको	नगरकोट को	नग रकोटको
छोडिदिँदा	छोडिदिँदा $	छो डिदिँदा
नगरकोट/नाल्दुम	नगरकोट/नाल्दुम $	नग रकोट/नाल्दुम
पर्यटकले	पर्यटक ले	पर् यटकले
दुःख	दुःख $	दुः ख
पाउनुका	पाउनु का	पाउनु का
साथै	साथै $	सा थै
व्यवसाय	व्यवसाय $	व्यवसा य
धराशायी	धराशायी $	धरा शायी
बनेको	बने को	ब नेको
व्यवसायीहरू	व्यवसायी हरू	व्यवसायी हरू
बताउँछन्	बताउँछन् $	बता उँछन्
आवातजावतमा	आवातजावत मा	आवा तजावतमा
परेको	परे को	प रेको
नाल्दुम	नाल्दुम $	ना ल्दुम
समितिका	समिति का	स मितिका
धनबहादुर	धनबहादुर $	धन बहादुर
लामाले	लामा ले	ला माले
नगरकोटको	नगरकोट को	नग रकोटको
हेरेर	हेरेर $	हेरे र
पर्यटकले	पर्यटक ले	पर् यटकले
गाली	गाली $	गा ली
गर्छन्	गर्छन् $	गर्छ न्
तत्काल	तत्काल $	तत्का ल
नभए	नभए $	न भए
कागजमै	कागज मै	कागज मै
सीमित	सीमित $	सी मित
कालोपत्रेसमेत	कालोपत्रे समेत	कालोपत्रे समेत
बनेको	बने को	ब नेको
उनको	उन को	उ नको
मार्गको	मार्ग को	मार् गको
सडकलाई	सडक लाई	सड कलाई
वर्षौंसम्म	वर्षौं सम्म	वर्षौं सम्म
पर्यटकलाई	पर्यटक लाई	पर्यट कलाई
प्रत्यक्ष	प्रत्यक्ष $	प्रत्यक् ष
परेको	परे को	प रेको
व्यवसायी	व्यवसायी $	व्यवसा यी
धीरज	धीरज $	धीर ज
लामाले	लामा ले	ला माले
प्रवर्द्धनका	प्रवर्द्धन का	प्र वर्द्धनका
जतिसक्दो	जतिसक्दो $	जति सक्दो
छिटो	छिटो $	छि टो
लामाले	लामा ले	ला माले
अनुगमनमा	अनुगमन मा	अनु गमनमा
आएका	आए का	आ एका
संसदीयटोलीमाझ	संसदीयटोली माझ	सं सदीयटोलीमाझ
पोखे	पोखे $	पो खे
सन्	सन् $	स न्
जुनमा	जुन मा	जु नमा
सुरु	सुरु $	सु रु
वर्षभित्र	वर्ष भित्र	वर्षभित् र
सक्ने	सक्ने $	सक् ने
लक्ष्य	लक्ष्य $	लक् ष्य
हालसम्म	हाल सम्म	हाल सम्म
रिटेनिङ	रिटेनिङ $	रि टेनिङ
वाल	वाल $	वा ल
भएको	भए को	भ एको
अधिकांश	अधिकांश $	अधिकां श
स्थानमा	स्थान मा	स्था नमा
भत्किसकेको	भत्कि सकेको	भत्कि सकेको
डीबीएसडी	डीबीएसडी $	डी बीएसडी
उक्किसकेको	उक्कि सकेको	उक्कि सकेको
साढे	साढे $	सा ढे
मिटरको	मिटर को	मिटर को
सडकलाई	सडक लाई	सड कलाई
बढाएर	बढाएर $	बढा एर
मिटर	मिटर $	मिट र
नाली–ढलको	नाली–ढलको $	नाली–ढ लको
घुम्तीमा	घुम्ती मा	घुम्ती मा
मिटरसम्मको	मिटर सम्मको	मिटर सम्मको
फराकिलो	फराकिलो $	फराकि लो
योजनासहित	योजना सहित	योजना सहित
आयोजनाले	आयोजना ले	आयोजना ले
विस्तारको	विस्तार को	विस्तार को
पाएका	पाए का	पा एका
कन्स्ट्रक्सन	कन्स्ट्रक्सन $	कन्स्ट्र क्सन
प्रालिलाई	प्रालि लाई	प्रा लिलाई
समयावधिमै	समयावधि मै	सम यावधिमै
पटक/पटक	पटक/पटक $	पटक /पटक
दिँदा	दिँदा $	दिँ दा
समेत	समेत $	स मेत
नभएकाले	नभएका ले	नभएका ले
संघीय	संघीय $	सं घीय
संसद्	संसद् $	सं सद्
समितिलाई	समिति लाई	समि तिलाई
गुहार्न	गुहार्न $	गुहा र्न
बाध्य	बाध्य $	बाध् य
भएको	भए को	भ एको
मिश्रले	मिश्र ले	मिश् रले
निमार्ण	निमार्ण $	निमा र्ण
व्यवसायीका	व्यवसायी का	व्यवसायी का
प्रतिनिधिले	प्रतिनिधि ले	प्रति निधिले
सुदन	सुदन $	सु दन
गौलीले	गौली ले	गौ लीले
निमार्णको	निमार्ण को	निमा र्णको
अभाव	अभाव $	अभा व
स्थानीयको	स्थानीय को	स्थानी यको
अवरोध	अवरोध $	अव रोध
वन	वन $	व न
क्षेत्रका	क्षेत्र का	क्षे त्रका
रुखहरू	रुख हरू	रु खहरू
समयमै	समय मै	सम यमै
कटान	कटान $	क टान
समयमै	समय मै	सम यमै
नसकिएको	नसकिए को	नस किएको
भेरिएसन	भेरिएसन $	भेरिए सन
अर्डर	अर्डर $	अर् डर
ढिला	ढिला $	ढि ला
निकासा	निकासा $	नि कासा
बाँकी	बाँकी $	बाँ की
भएकालेपनि	भएकाले पनि	भएका लेपनि
भएको	भए को	भए को
आन्दोलनमा	आन्दोलन मा	आन्दोलन मा
भक्तपुरको	भक्तपुर को	भक् तपुरको
भत्केको	भत्के को	भत् केको
पाटी	पाटी $	पा टी
हुँदै	हुँदै $	हुँ दै
वर्षसम्म	वर्ष सम्म	वर्ष सम्म
नभएपछि	नभए पछि	नभ एपछि
आन्दोलनमा	आन्दोलन मा	आन् दोलनमा
उत्रिएका	उत्रिए का	उत् रिएका
धूवाँ	धूवाँ $	धू वाँ
खाल्डाखुल्डीका	खाल्डाखुल्डी का	खाल्डाखुल् डीका
जनजीवन	जनजीवन $	जन जीवन
बनेको	बने को	ब नेको
बासिन्दा	बासिन्दा $	बासि न्दा
आन्दोलनमा	आन्दोलन मा	आन्दोलन मा
उत्रिएका	उत्रिए का	उत् रिएका
वर्षमा	वर्ष मा	वर् षमा
भइसक्नुपर्ने	भइसक्नु पर्ने	भइसक् नुपर्ने
भत्केको	भत्के को	भत् केको
पार्टी–नगरकोट	पार्टी–नगरकोट $	पार्टी –नगरकोट
वर्षमा	वर्ष मा	वर् षमा
नबनेपछि	नबने पछि	नबने पछि
स्थानीयले	स्थानीय ले	स्थानी यले
सदस्यीय	सदस्यीय $	सदस् यीय
संघर्ष	संघर्ष $	संघ र्ष
गठन	गठन $	ग ठन
गरेरआन्दोलन	गरेरआन्दोलन $	गरेरआ न्दोलन
गरिरहेका	गरि रहेका	गरिर हेका
भारतको	भारत को	भार तको
सहयोगमा	सहयोग मा	सहयोग मा
भत्केको	भत्के को	भत् केको
पाटी–खरिपाटी–तेलकोट–नगरकोट	पाटी–खरिपाटी–तेलकोट–नगरकोट $	पा टी–खरिपाटी–तेलकोट–नगरकोट
खण्डको	खण्ड को	खण् डको
किमि	किमि $	कि मि
आयोजनाको	आयोजना को	आयोजना को
पाएको	पाए को	पा एको
कन्स्ट्रक्सनले	कन्स्ट्रक्सन ले	कन्स्ट्रक्स नले
वर्षमा	वर्ष मा	व र्षमा
बनाएपछि	बनाए पछि	बना एपछि
आन्दोलित	आन्दोलित $	आन्दो लित
बनेका	बने का	ब नेका
खण्डअन्तर्गतका	खण्डअन्तर्गत का	खण्ड अन्तर्गतका
मण्डनदेउपुर	मण्डनदेउपुर $	मण्डनदेउ पुर
छालिङ	छालिङ $	छा लिङ
बागेश्वरी	बागेश्वरी $	बा गेश्वरी
सुडालका	सुडाल का	सुडा लका
बासिन्दाको	बासिन्दा को	बा सिन्दाको
भेलाले	भेला ले	भे लाले
लामिछानेको	लामिछाने को	लामिछा नेको
संयोजकत्वमा	संयोजकत्व मा	सं योजकत्वमा
गरेका	गरे का	ग रेका
समितिले	समिति ले	समि तिले
नगरपालिका	नगरपालि का	नग रपालिका
प्रशासन	प्रशासन $	प्रशा सन
समितिसमेतलाई	समितिसमेत लाई	समितिसमे तलाई
दिँदै	दिँदै $	दिँ दै
आएको	आए को	आए को
लामिछानेले	लामिछाने ले	लामिछा नेले
भर्खरै	भर्खरै $	भ र्खरै
माध्यमिक	माध्यमिक $	मा ध्यमिक
परीक्षा	परीक्षा $	परीक् षा
उत्तीर्ण	उत्तीर्ण $	उत् तीर्ण
विद्यार्थी	विद्यार्थी $	विद् यार्थी
कक्षा	कक्षा $	कक् षा
पढ्ने	पढ्ने $	प ढ्ने
सुरसार	सुरसार $	सुर सार
सालको	साल को	सा लको
एसईईमा	एसईई मा	एस ईईमा
जनामध्ये	जना मध्ये	जनाम ध्ये
दृष्टिविहीन	दृष्टि विहीन	दृष्टि विहीन
दृष्टिहीन	दृष्टिहीन $	दृष्टि हीन
विद्यार्थीको	विद्यार्थी को	विद् यार्थीको
ग्रेड	ग्रेड $	ग् रेड
जीपीए	जीपीए $	जी पीए
उत्कृष्ट	उत्कृष्ट $	उत् कृष्ट
दृष्टिविहीन	दृष्टि विहीन	दृष्टि विहीन
विद्यार्थीले	विद्यार्थी ले	विद्यार् थीले
तरखरमा	तरखर मा	तर खरमा
छन्/छैनन्	छन्/छैनन् $	छन् /छैनन्
लेखाजोखा	लेखाजोखा $	ले खाजोखा
निकाय	निकाय $	नि काय
मौन	मौन $	मौ न
देशभरिका	देशभरि का	देश भरिका
विद्यालयमा	विद्यालय मा	वि द्यालयमा
दृष्टिविहीन	दृष्टि विहीन	दृष्टि विहीन
त्यो	त्यो $	त् यो
मात्र	मात्र $	मात् र
मन्त्रालयले	मन्त्रालय ले	मन्त्रालय ले
ब्रेल	ब्रेल $	ब् रेल
पाठ्यपुस्तक	पाठ्यपुस्तक $	पाठ्य पुस्तक
सामग्री	सामग्री $	सा मग्री
गरेको	गरे को	गरे को
त्यसैले	त्यसै ले	त्य सैले
एईई	एईई $	ए ईई
दृष्टिविहीन	दृष्टि विहीन	दृष्टि विहीन
कहाँ	कहाँ $	क हाँ
पढ्दै	पढ्दै $	पढ् दै
निकायलाई	निकाय लाई	निका यलाई
थाहा	थाहा $	था हा
संविधानको	संविधान को	संविधा नको
धारा	धारा $	धा रा
भनिएको	भनिए को	भ निएको
दृष्टिविहीन	दृष्टि विहीन	दृष्टि विहीन
नागरिकलाई	नागरिक लाई	नागरि कलाई
ब्रेललिपि	ब्रेललिपि $	ब् रेललिपि
बहिरा	बहिरा $	ब हिरा
स्वर	स्वर $	स्व र
बोलाइसम्बन्धी	बोलाइ सम्बन्धी	बोलाइ सम्बन्धी
भएका	भए का	भए का
नागरिकलाई	नागरिक लाई	नागरि कलाई
सांकेतिक	सांकेतिक $	सांके तिक
भाषाका	भाषा का	भाषा का
माध्यमबाट	माध्यम बाट	माध्य मबाट
कानुनबमोजिम	कानुन बमोजिम	कानुन बमोजिम
निःशुल्क	निःशुल्क $	निःशुल् क
पाउने	पाउने $	पा उने
हक	हक $	ह क
हुनेछ	हुनेछ $	हु नेछ
व्यवहारमा	व्यवहार मा	व् यवहारमा
माथि	माथि $	मा थि
दृष्टिविहीनका	दृष्टिविहीन का	दृष्टि विहीनका
औपचारिक	औपचारिक $	औपचा रिक
पठनपाठनको	पठनपाठन को	पठनपाठ नको
सुविधाको	सुविधा को	सु विधाको
नरहेको	नरहे को	न रहेको
स्वीकारोक्ति	स्वीकारोक्ति $	स्वी कारोक्ति
मन्त्रालयका	मन्त्रालय का	मन्त्राल यका
अधिकारीहरूको	अधिकारी हरूको	अधिकारी हरूको
देशकै	देश कै	देश कै
पहिलो	पहिलो $	प हिलो
दृष्टिविहीनका	दृष्टिविहीन का	दृष्टि विहीनका
स्थापित	स्थापित $	स्था पित
कीर्तिपुरस्थित	कीर्तिपुर स्थित	कीर्ति पुरस्थित
ल्याबरेटरी	ल्याबरेटरी $	ल्या बरेटरी
माविबाट	मावि बाट	मावि बाट
यसपटक	यस पटक	यसप टक
जनाले	जना ले	जना ले
एसईई	एसईई $	एस ईई
गरेका	गरे का	ग रेका
त्यहाँ	त्यहाँ $	त्य हाँ
दृष्टिविहीनका	दृष्टिविहीन का	दृष्टि विहीनका
यहाँ	यहाँ $	य हाँ
नभएकाले	नभएका ले	नभए काले
आआफ्नै	आआफ्नै $	आआ फ्नै
रोजाइमा	रोजाइ मा	रोजा इमा
कलेजमा	कलेज मा	कले जमा
जान्छन्	जान्छन् $	जान् छन्
प्रधानाध्यापक	प्रधानाध्यापक $	प्रधा नाध्यापक
लाक्पा	लाक्पा $	ला क्पा
शेर्पा	शेर्पा $	शे र्पा
कीर्तिपुरस्थित	कीर्तिपुर स्थित	कीर्ति पुरस्थित
माविबाट	मावि बाट	मावि बाट
यसपालिको	यसपालि को	यस पालिको
एसईईमा	एसईई मा	एस ईईमा
ल्याएकी	ल्याए की	ल्याए की
स्मारिका	स्मारि का	स्मा रिका
पोखरेल	पोखरेल $	पोख रेल
दृष्टिविहीन	दृष्टि विहीन	दृष्टि विहीन
धुम्बाराहीस्थित	धुम्बाराही स्थित	धुम्बाराही स्थित
साइपल	साइपल $	साइ पल
एकेडेमीमा	एकेडेमी मा	ए केडेमीमा
लेभल	लेभल $	ले भल
पढदै	पढदै $	प ढदै
छिन्	छिन् $	छि न्
दृष्टिविहीनले	दृष्टिविहीन ले	दृष्टि विहीनले
ननसाइन्सका	ननसाइन्स का	ननसाइन् सका
विषय	विषय $	विष य
उनले	उन ले	उन ले
सोसलोजी	सोसलोजी $	सो सलोजी
साइकोलोजी	साइकोलोजी $	साइ कोलोजी
जनरल	जनरल $	जन रल
पेपर	पेपर $	पे पर
बिजनेस	बिजनेस $	बि जनेस
स्टडिज	स्टडिज $	स् टडिज
रोजेकी	रोजे की	रो जेकी
विषयमा	विषय मा	विषय मा
पुस्तक	पुस्तक $	पुस् तक
पाइन्न	पाइन्न $	पाइ न्न
कलेजलाई	कलेज लाई	कले जलाई
सुनाएरै	सुनाएरै $	सुनाए रै
भएर	भएर $	भ एर
पढेकी	पढे की	पढे की
छात्रा	छात्रा $	छा त्रा
पोखरेलका	पोखरेल का	पोखरे लका
सात	सात $	सा त
साथीमध्ये	साथी मध्ये	साथी मध्ये
चारजना	चारजना $	चार जना
बत्तीसपुतलीस्थित	बत्तीसपुतली स्थित	बत्तीसपुतली स्थित
गोल्डेन	गोल्डेन $	गोल् डेन
गेट	गेट $	गे ट
कलेजमा	कलेज मा	कले जमा
भएका	भए का	भ एका
चार	चार $	चा र
जनाले	जना ले	जना ले
विशेष	विशेष $	वि शेष
छुटसहित	छुट सहित	छुट सहित
पाएका	पाए का	पा एका
सीमा	सीमा $	सी मा
तामाङले	तामाङ ले	तामा ङले
कलेजमा	कलेज मा	कले जमा
शिक्षकले	शिक्षक ले	शिक्ष कले
गाइड	गाइड $	गा इड
गर्नुहुन्छ	गर्नुहुन्छ $	गर् नुहुन्छ
भन्ने	भन्ने $	भन् ने
हामीभन्दा	हामी भन्दा	हामी भन्दा
अघिल्लो	अघिल्लो $	अघि ल्लो
ब्याचका	ब्याच का	ब् याचका
साथीबाट	साथी बाट	साथी बाट
पायौं	पायौं $	पा यौं
गाह्रो	गाह्रो $	गाह् रो
होमवर्क	होमवर्क $	होमव र्क
बुक	बुक $	बु क
सरले	सर ले	सर ले
कम्प्युटरमा	कम्प्युटर मा	कम् प्युटरमा
गरेर	गरेर $	ग रेर
इमेलबाट	इमेल बाट	इमे लबाट
पठाऊ	पठाऊ $	पठा ऊ
भन्नुहुन्छ	भन्नुहुन्छ $	भन्नु हुन्छ
त्यत्ति	त्यत्ति $	त्य त्ति
सजिलो	सजिलो $	स जिलो
पत्रकारिता	पत्रकारिता $	पत्रकारि ता
समाजशास्त्र	समाजशास्त्र $	समाज शास्त्र
अंग्रेजी	अंग्रेजी $	अं ग्रेजी
ऐच्छिक	ऐच्छिक $	ऐच्छि क
राजेकी	राजे की	रा जेकी
उनले	उन ले	उ नले
कक्षामा	कक्षा मा	क क्षामा
सुनेकै	सुने कै	सुने कै
भरमा	भर मा	भर मा
पढ्नुपर्नेछ	पढ्नुपर्नेछ $	पढ् नुपर्नेछ
बोर्ड	बोर्ड $	बो र्ड
परीक्षामा	परीक्षा मा	परीक्षा मा
लेखक	लेखक $	लेख क
राख्नुपर्ने	राख्नु पर्ने	राख् नुपर्ने
बाध्यता	बाध्यता $	बाध् यता
रहेको	रहे को	र हेको
उनले	उन ले	उन ले
सुनाइन्	सुनाइन् $	सुना इन्
दृष्टिविहीन	दृष्टि विहीन	दृष्टि विहीन
विज्ञान	विज्ञान $	विज्ञा न
संकायका	संकाय का	संका यका
पढ्न	पढ्न $	पढ् न
वञ्चित	वञ्चित $	व ञ्चित
गरेका	गरे का	ग रेका
गणित	गणित $	ग णित
चित्र	चित्र $	चि त्र
रेखा	रेखा $	रे खा
आदि	आदि $	आ दि
प्रयोग	प्रयोग $	प्र योग
प्रश्नपत्र	प्रश्नपत्र $	प्रश्न पत्र
सधैं	सधैं $	स धैं
छोड्नुपरेको	छोड्नुपरे को	छोड्नु परेको
उनीहरू	उनी हरू	उनी हरू
दृष्टिविहीन	दृष्टि विहीन	दृष्टि विहीन
कल्याण	कल्याण $	कल् याण
संघका	संघ का	सं घका
कुमार	कुमार $	कु मार
थापा	थापा $	था पा
तह	तह $	त ह
व्यवहारमा	व्यवहार मा	व्यवहा रमा
लागू	लागू $	ला गू
नसकेको	नसके को	न सकेको
दृष्टिविहीन	दृष्टि विहीन	दृष्टि विहीन
पढाउने	पढाउने $	पढा उने
विद्यालयले	विद्यालय ले	विद्यालय ले
कक्षासम्मै	कक्षा सम्मै	कक्षा सम्मै
पढाउन	पढाउन $	पढा उन
जरुरी	जरुरी $	ज रुरी
पाल्पा	पाल्पा $	पा ल्पा
बाराका	बारा का	बा राका
विद्यालयले	विद्यालय ले	विद्यालय ले
दृष्टिविहीन	दृष्टि विहीन	दृष्टि विहीन
विद्यार्थीलाई	विद्यार्थी लाई	विद् यार्थीलाई
पढाएको	पढाए को	पढा एको
त्यसैअनुसार	त्यसै अनुसार	त्यसै अनुसार
सरकारले	सरकार ले	सर कारले
छात्रवृत्ति	छात्रवृत्ति $	छात् रवृत्ति
सहायक	सहायक $	सहा यक
उपलब्ध	उपलब्ध $	उ पलब्ध
गराउन	गराउन $	गराउ न
स्थिति	स्थिति $	स् थिति
उल्टो	उल्टो $	उ ल्टो
भएको	भए को	भ एको
दृष्टिविहीन	दृष्टि विहीन	दृष्टि विहीन
अन्यायमा	अन्याय मा	अन् यायमा
परेका	परे का	परे का
नेत्रहीन	नेत्रहीन $	नेत्र हीन
संघका	संघ का	सं घका
कार्यकारी	कार्यकारी $	कार्य कारी
सल्लाहकार	सल्लाहकार $	सल्लाह कार
नरबहादुर	नरबहादुर $	न रबहादुर
लिम्बूले	लिम्बू ले	लिम्बू ले
संविधानलाई	संविधान लाई	संविधा नलाई
सरकारले	सरकार ले	सरकार ले
बेवास्ता	बेवास्ता $	बेवा स्ता
नमिल्ने	नमिल्ने $	नमि ल्ने
दृष्टिविहीनका	दृष्टिविहीन का	दृष्टि विहीनका
स्नातक	स्नातक $	स्नात क
स्नातकोत्तरसम्म	स्नातकोत्तर सम्म	स्नातकोत्त रसम्म
औचारिक	औचारिक $	औचा रिक
शब्दकोश	शब्दकोश $	शब्द कोश
व्याकरण	व्याकरण $	व्या करण
भएको	भए को	भए को
उनले	उन ले	उ नले
सरकारले	सरकार ले	सरका रले
गम्भीरतापूर्वक	गम्भीरता पूर्वक	गम्भीर तापूर्वक
सोचेर	सोचेर $	सो चेर
मन्त्रालयका	मन्त्रालय का	मन्त्रालय का
प्रवक्ता	प्रवक्ता $	प्र वक्ता
बैकुण्ठ	बैकुण्ठ $	बैकुण् ठ
अर्यालले	अर्याल ले	अर् यालले
भएकाले	भएका ले	भए काले
निर्माणमासमस्या	निर्माणमासमस्या $	निर्माण मासमस्या
रहेको	रहे को	रहे को
उनले	उन ले	उ नले
कुन	कुन $	कु न
विषयलाई	विषय लाई	विष यलाई
भन्नेबारे	भन्ने बारे	भन्ने बारे
विकल्पको	विकल्प को	वि कल्पको
खोजी	खोजी $	खो जी
गरिँदै	गरिँदै $	ग रिँदै
विकल्पबारे	विकल्प बारे	विकल्प बारे
निष्कर्षमा	निष्कर्ष मा	निष्क र्षमा
पुग्न	पुग्न $	पुग् न
रहेको	रहे को	र हेको
उनले	उन ले	उ नले
जनाए	जनाए $	ज नाए
परीक्षामा	परीक्षा मा	परी क्षामा
दृष्टिविहीन	दृष्टि विहीन	दृष्टि विहीन
विद्यार्थीले	विद्यार्थी ले	विद्यार् थीले
लिपिमा	लिपि मा	लि पिमा
लेखन	लेखन $	लेख न
उपकरण	उपकरण $	उप करण
भोग्नुपरेको	भोग्नुपरे को	भोग्नु परेको
जतिखेर	जतिखेर $	ज तिखेर
नजिक	नजिक $	न जिक
आउँछ	आउँछ $	आ उँछ
त्यतिखेर	त्यतिखेर $	त्य तिखेर
जाँचमा	जाँच मा	जाँच मा
लेखिदिने	लेखिदिने $	लेखिदि ने
खोज्नुपर्छ	खोज्नुपर्छ $	खोज् नुपर्छ
नियमानुसार	नियमानुसार $	नियमा नुसार
दृष्टिविहीन	दृष्टि विहीन	दृष्टि विहीन
विद्यार्थीले	विद्यार्थी ले	विद्यार् थीले
दिनुपर्ने	दिनु पर्ने	दि नुपर्ने
कक्षाभन्दा	कक्षा भन्दा	कक्षा भन्दा
मुनिकालाई	मुनिका लाई	मुनिका लाई
रोज्न	रोज्न $	रो ज्न
पाउँछन्	पाउँछन् $	पाउँ छन्
हलमा	हल मा	ह लमा
लेखकले	लेखक ले	लेख कले
पढेर	पढेर $	प ढेर
सुनाउँछ	सुनाउँछ $	सुना उँछ
परीक्षार्थीले	परीक्षार्थी ले	परीक्षा र्थीले
सुन्छ	सुन्छ $	सु न्छ
उसले	उस ले	उस ले
बुझेको	बुझे को	बु झेको
जवाफ	जवाफ $	ज वाफ
लेखकलाई	लेखक लाई	लेख कलाई
भन्छ/सुनाउँछ	भन्छ/सुनाउँछ $	भन्छ /सुनाउँछ
लेखकले	लेखक ले	लेख कले
त्यसैअनुसार	त्यसै अनुसार	त्यसै अनुसार
लेखिदिन्छ	लेखिदिन्छ $	लेखिदि न्छ
विद्यार्थीलाई	विद्यार्थी लाई	विद् यार्थीलाई
पूर्णांकको	पूर्णांक को	पूर् णांकको
घण्टाको	घण्टा को	घण् टाको
दिइन्छ	दिइन्छ $	दिइ न्छ
दृष्टिविहीन	दृष्टि विहीन	दृष्टि विहीन
भएका	भए का	भ एका
विद्यार्थीका	विद्यार्थी का	विद्यार्थी का
केन्द्राध्यक्षको	केन्द्राध्यक्ष को	केन्द् राध्यक्षको
अनुमतिमा	अनुमति मा	अनु मतिमा
बढीमा	बढी मा	बढी मा
डेढ	डेढ $	डे ढ
घण्टा	घण्टा $	घण् टा
केन्द्राध्यक्षले	केन्द्राध्यक्ष ले	केन्द् राध्यक्षले
गराउनै	गराउनै $	गराउ नै
मान्छन्	मान्छन् $	मा न्छन्
कीर्तिपुरस्थित	कीर्तिपुर स्थित	कीर्ति पुरस्थित
ल्याबोरेटरी	ल्याबोरेटरी $	ल्या बोरेटरी
माविका	मावि का	मा विका
दृष्टिविहीनका	दृष्टिविहीन का	दृष्टि विहीनका
गरेपछि	गरे पछि	गरे पछि
चाहिँदैन	चाहिँदैन $	चाहिँ दैन
अभ्यस्त	अभ्यस्त $	अभ् यस्त
शिक्षकले	शिक्षक ले	शिक्षक ले
केन्द्राध्यक्षलाई	केन्द्राध्यक्ष लाई	केन्द्राध्य क्षलाई
समस्याबारे	समस्या बारे	समस्या बारे
बुझाउनै	बुझाउनै $	बुझाउ नै
माविमा	मावि मा	मा विमा
दृष्टिविहीन	दृष्टि विहीन	दृष्टि विहीन
पढ्छन्	पढ्छन् $	पढ् छन्
शेर्पाका	शेर्पा का	शे र्पाका
विकसित	विकसित $	विक सित
मुलुकमा	मुलुक मा	मुलु कमा
दृष्टिविहीन	दृष्टि विहीन	दृष्टि विहीन
विद्यार्थीले	विद्यार्थी ले	विद्यार् थीले
ब्रेलमै	ब्रेल मै	ब् रेलमै
दिन्छन्	दिन्छन् $	दिन्छ न्
भनेर	भनेर $	भ नेर
ब्रेलमै	ब्रेल मै	ब् रेलमै
उत्तरपुस्तिका	उत्तरपुस्ति का	उत्तर पुस्तिका
जाँचिन्छ	जाँचिन्छ $	जाँचि न्छ
त्यसरी	त्यसरी $	त्यस री
ब्रेलमा	ब्रेल मा	ब्रे लमा
लिइएको	लिइए को	लिइ एको
परीक्षाको	परीक्षा को	परीक्षा को
उत्तरपुस्तिकालाई	उत्तरपुस्तिका लाई	उत्तर पुस्तिकालाई
साइकेट	साइकेट $	साइ केट
लेटर	लेटर $	लेट र
अक्षर	अक्षर $	अ क्षर
बदलिदिन्छ	बदलिदिन्छ $	बदलिदि न्छ
अनुवाद	अनुवाद $	अनु वाद
भएपछि	भए पछि	भ एपछि
अक्षरमा	अक्षर मा	अक्ष रमा
बुझिन्छ	बुझिन्छ $	बुझि न्छ
त्यसले	त्यस ले	त्यस ले
परीक्षण	परीक्षण $	परीक् षण
अंकभार	अंकभार $	अं कभार
सहज	सहज $	सह ज
नेपालको	नेपाल को	नेपा लको
विद्यालयमा	विद्यालय मा	विद् यालयमा
ब्रेलमै	ब्रेल मै	ब् रेलमै
ब्रेलमै	ब्रेल मै	ब् रेलमै
मार्क्स	मार्क्स $	मार् क्स
परीक्षाको	परीक्षा को	परीक्षा को
छाप्न	छाप्न $	छा प्न
संस्था	संस्था $	संस् था
विद्यालय	विद्यालय $	वि द्यालय
सम्मको	सम्म को	स म्मको
छपाउन	छपाउन $	छपा उन
नेपालमा	नेपाल मा	ने पालमा
हालसम्म	हाल सम्म	हाल सम्म
काठमाडौंको	काठमाडौं को	काठमाडौं को
दृष्टिविहीन	दृष्टि विहीन	दृष्टि विहीन
संघ	संघ $	सं घ
संघले	संघ ले	संघ ले
छपाउँदै	छपाउँदै $	छपा उँदै
आएका	आए का	आ एका
दृष्टिहीनका	दृष्टिहीन का	दृष्टि हीनका
अनिवार्य	अनिवार्य $	अनि वार्य
विषयअन्तर्गत	विषयअन्तर्गत $	विषय अन्तर्गत
जनसंख्या	जनसंख्या $	जन संख्या
विषयको	विषय को	विष यको
आएको	आए को	आए को
विद्यार्थीलाई	विद्यार्थी लाई	विद्यार्थी लाई
गराइएको	गराइए को	गरा इएको
प्रकारको	प्रकार को	प्रका रको
छपाइ	छपाइ $	छपा इ
मेसिन	मेसिन $	मे सिन
भएकाले	भएका ले	भए काले
प्रेस	प्रेस $	प्रे स
छापाखानाले	छापाखाना ले	छापा खानाले
जनाइएको	जनाइए को	जना इएको
मन्त्रालयले	मन्त्रालय ले	मन्त्राल यले
गराएको	गराए को	गरा एको
पठनपाठन	पठनपाठन $	पठनपा ठन
विषयभित्र	विषय भित्र	विषय भित्र
समेटिएका	समेटिए का	समे टिएका
विषयवस्तु	विषयवस्तु $	विषयवस् तु
लिपिमा	लिपि मा	लि पिमा
उतार्ने	उतार्ने $	उता र्ने
सियोले	सियो ले	सि योले
घोचेजसरी	घोचेजसरी $	घोचेज सरी
छेडिएर	छेडिएर $	छेडि एर
खोपिने	खोपिने $	खो पिने
लिपि	लिपि $	लि पि
पुस्तकको	पुस्तक को	पुस्त कको
आकार	आकार $	आका र
कक्षागत	कक्षागत $	कक्षा गत
पाठ्यपुस्तकभन्दा	पाठ्यपुस्तक भन्दा	पाठ्य पुस्तकभन्दा
ठूलो	ठूलो $	ठू लो
कतिपय	कतिपय $	कतिप य
विषयको	विषय को	विषय को
दुईभन्दा	दुई भन्दा	दुई भन्दा
खण्डमा	खण्ड मा	ख ण्डमा
विभाजन	विभाजन $	विभा जन
छाप्ने	छाप्ने $	छा प्ने
गरिएको	गरिए को	ग रिएको
विद्यार्थीका	विद्यार्थी का	विद्यार्थी का
सेट	सेट $	से ट
पुस्तकको	पुस्तक को	पुस्त कको
मूल्य	मूल्य $	मू ल्य
जनाइएको	जनाइए को	जना इएको
आकारको	आकार को	आका रको
मात्रामा	मात्रा मा	मात्रा मा
भएकाले	भएका ले	भए काले
साथीमाझ	साथी माझ	साथी माझ
आलोपालो	आलोपालो $	आ लोपालो
गरेको	गरे को	गरे को
पोखरेलले	पोखरेल ले	पोखरे लले
एउटै	एउटै $	ए उटै
विषयको	विषय को	विष यको
ब्रेलमा	ब्रेल मा	ब्रे लमा
तीनवटा	तीन वटा	तीन वटा
किताब	किताब $	किता ब
उनले	उन ले	उ नले
त्यसैले	त्यसै ले	त्य सैले
साथीसित	साथी सित	साथी सित
बाँडेर	बाँडेर $	बाँ डेर
पढ्यौं	पढ्यौं $	पढ् यौं
त्यस्तो	त्यस्तो $	त्यस् तो
अपर्याप्त	अपर्याप्त $	अप र्याप्त
तहका	तह का	तह का
विद्यार्थीले	विद्यार्थी ले	विद्यार् थीले
वार्षिक	वार्षिक $	वार् षिक
पाउँदै	पाउँदै $	पाउँ दै
आएका	आए का	आ एका
ब्रेलका	ब्रेल का	ब्रे लका
विद्यार्थीले	विद्यार्थी ले	विद्यार् थीले
व्यक्तिगत	व्यक्तिगत $	व्यक्ति गत
गृहकार्य	गृहकार्य $	गृहका र्य
स्लेट	स्लेट $	स् लेट
स्टाइल्स	स्टाइल्स $	स्टाइ ल्स
पेपरसमेत	पेपर समेत	पेपर समेत
गराए	गराए $	गरा ए
न्याय	न्याय $	न्या य
सक्छ	सक्छ $	स क्छ
दृष्टिविहीन	दृष्टि विहीन	दृष्टि विहीन
संघकी	संघ की	संघ की
निर्देशक	निर्देशक $	निर्देश क
डा.	डा. $	डा .
मालिका	मालिका $	मालि का
प्रसाइँ	प्रसाइँ $	प्रसा इँ
भन्छिन्	भन्छिन् $	भ न्छिन्
अहिलेसम्म	अहिले सम्म	अहिले सम्म
भाषाको	भाषा को	भाषा को
ब्रेलमा	ब्रेल मा	ब्रे लमा
विद्यार्थीको	विद्यार्थी को	विद् यार्थीको
भाषा	भाषा $	भा षा
पढाइमा	पढाइ मा	पढाइ मा
विद्यार्थीले	विद्यार्थी ले	विद्यार् थीले
काठमाडौंकै	काठमाडौं कै	काठमाडौं कै
विद्यालयमा	विद्यालय मा	विद्यालय मा
दृष्टिविहीनले	दृष्टिविहीन ले	दृष्टि विहीनले
सुनेर	सुनेर $	सुने र
कम्प्युटर	कम्प्युटर $	कम् प्युटर
सफ्टवेयर	सफ्टवेयर $	स फ्टवेयर
